wwwwwwwwwwwwwwwwwwwwwwwwww
w------------g-----------w
w------------------------w
w------------------------w
w------------------------w
w------------------------w
w------------------------w
w------------!-----------w
w------------------------w
w------------------------w
w------------------------w
w------------------------w
w------------------------w
w------------------------w
w------------------------w
w------------------------w
w------------p-----------w
wwwwwwwwwwwwwwwwwwwwwwwwww